NO              ./tex/north.png













              SO      ./tex/south.png









WE ./tex/west.png



        EA                     ./tex/east.png

F 255,218,221




C             54,21,9

                              1
                             101
                             101
                             101
                      1      101
                     101    1101
                     101    1001
                     101   1001
                     101  10001
                     1011100001
        1111111111111000000000011
        1W00000000110000000000101
        100000000111000000000101
        1001000000000000000000101
111111111011111111110000000000001
100000000011     1110111111111111
111101111111     100000010001               1111
111101111111     101010010001           11110001
 10000001101     10000010001111111     10000011
100000000001     1000000100000000011111101111
100000000001111111010100100000000000000001
11000001110000000001011110000000000111111
11110111 11101011101011010001111111     
11110111 1111111 111111110011
   1011                  1001
   10001                 10001
    1101                 100001
     100111111111111111111000001
      1000000000000000000000011
       1111111111111111111111
